EEO = Elliptical Earth Orbit
EEO/M = Molynia (12-hr) Elliptical Earth Orbit
EEO/T = Tundra (24-hr) Elliptical Earth Orbit
FTO = Failed to Orbit
FSO = Failed Suborbital
GTO = Geosynchronous Transfer Orbit
GTO+ = Supersynchronous or High Perigee Transfer Orbit
GTO/+ = Supersynchronous or High Perigee Transfer Orbit
GTO- = Subsynchronous Transfer Orbit
GTOi = Inclined Geosynchronous Transfer Orbit
GTO/i = Inclined Geosynchronous Transfer Orbit
GEO = Geosynchronous Orbit
GEO- = Subsynchronous Geosynchronous Orbit
GSO = Geosynchronous Orbit
GEO/i = Inclined Geosynchronous Orbit
GTO/GEO = Geosynchronous Transfer Orbit or Geosynchronous Orbit
HCO = Heliocentric (solar) Orbit
HEO = Heliocentric Earth Orbit
HTO = High Earth Transfer Orbit
LEO = Low Earth Orbit
LEO/E = Equatorial Low Earth Orbit
LEO/S = Sun Synchronous Low Earth Orbit
LEO/P = Polar Low Earth Orbit
LEO/R = Retrograde Low Earth Orbit
LEO/ISS = Low Earth Orbit at same altitude as International Space Station
MEO = Medium Earth Orbit
MTO = Medium Earth Transfer Orbit
SUB = Suborbital
TLI = Trans Lunar Injection
PAD = Blew up on the pad ?